5 5 4 4 5 5 4 4 5 4 5 5 4 5 4 5 5 4 4 5 5 4 5 5 4 5 4 4 5 4 4 4 5 5 5 4 4 4 4 5 4 5 5 4 5 4 4 5 4 4 5 5 5 4 4 5 4 4 5 4 4 4 5 5 4 4 5 4 4 4 5 5 5 4 4 5 5 5 4 5 4 4 4 4 4 5 4 4 5 4 5 4 5 5 5 4 5 4 5 5
1 4 5 5 4 4 4 4 5 4 5 4 5 4 5 4 5 5 5 5 4 4 5 5 5 4 5 5 5 5 5 5 4 4 4 5 4 4 4 5 4 5 5 5 5 4 5 4 5 4 5 5 5 5 4 5 4 4 4 5 4 5 5 5 4 5 4 5 4 5 5 4 4 5 4 5 5 4 5 4 5 4 5 4 5 4 5 5 5 5 4 4 4 4 4 4 5 4 5 4
1 5 5 5 4 5 5 5 5 5 5 4 0 4 5 5 4 5 5 4 4 4 4 4 4 4 4 4 4 5 5 4 5 5 5 5 5 5 4 5 4 5 4 5 4 4 5 5 4 5 4 5 4 5 5 4 5 5 5 4 4 4 4 5 4 4 5 4 5 4 5 4 4 4 5 4 4 4 5 5 4 5 4 5 4 5 4 5 5 4 4 4 5 5 4 4 4 4 4 5
4 5 4 5 4 4 4 5 4 5 4 5 4 5 5 5 5 5 5 4 4 4 5 5 5 5 5 4 4 5 4 4 5 5 5 4 4 5 4 4 5 4 4 5 5 5 5 4 5 5 5 5 5 4 5 4 4 4 4 4 5 4 4 4 4 5 5 4 4 5 4 5 5 4 5 5 5 5 4 4 5 4 5 4 4 4 4 5 5 5 5 4 5 4 5 5 5 4 5 5
5 1 4 4 4 5 4 5 4 4 4 5 5 4 5 5 4 5 5 4 5 4 5 5 4 5 4 4 4 4 4 5 5 4 4 4 4 4 4 4 5 5 4 4 4 5 4 4 5 5 4 5 4 4 4 5 5 5 5 4 4 5 4 5 5 5 4 4 4 4 4 4 4 4 5 4 4 4 4 5 4 4 4 4 5 5 4 5 4 5 5 5 4 5 5 4 4 5 4 5
4 4 5 5 4 5 4 4 5 5 4 5 5 5 4 4 4 4 5 4 5 5 4 5 5 5 4 5 5 4 4 4 5 5 5 4 4 4 4 4 4 4 5 5 4 5 4 4 5 4 4 5 4 4 4 4 5 5 5 5 5 5 4 5 4 4 4 5 5 5 4 4 4 4 4 5 4 5 4 4 5 4 4 5 5 4 5 5 5 5 5 4 5 4 4 4 4 5 4 5
4 5 5 5 5 5 5 4 4 5 5 4 4 4 5 4 4 5 4 4 5 4 5 5 4 4 4 4 5 5 5 4 5 4 5 5 4 4 4 4 4 5 5 4 4 5 4 5 5 4 4 4 4 4 5 4 5 4 5 5 4 4 4 5 5 5 5 4 4 5 5 4 5 5 4 4 4 5 4 4 4 4 4 4 5 4 4 5 5 4 5 4 5 5 5 5 4 4 5 5
4 5 4 5 4 5 4 5 5 4 4 5 4 5 4 5 4 4 5 4 4 4 4 5 4 4 5 4 4 4 4 5 4 5 4 5 5 5 5 4 5 5 4 5 5 5 4 4 4 4 5 4 4 5 5 5 4 5 4 4 5 4 4 4 5 4 4 4 4 5 4 5 5 4 4 4 5 4 4 5 4 5 5 4 5 5 5 4 5 4 4 5 5 4 4 4 4 4 5 4
5 5 5 4 5 4 4 4 5 4 4 5 5 5 4 4 5 4 4 4 5 4 5 5 5 5 5 4 4 4 4 4 4 5 5 4 4 4 4 5 5 5 4 5 5 4 5 5 4 5 4 5 5 5 5 4 5 5 4 5 4 5 4 5 4 4 5 5 4 4 5 4 5 5 5 4 4 4 5 5 5 4 5 5 4 4 5 4 5 5 4 4 5 4 4 5 4 5 5 5
4 4 5 5 5 5 5 5 5 4 5 4 4 5 4 4 5 5 5 5 5 4 5 4 5 4 4 5 5 4 5 4 4 4 4 4 4 4 4 5 5 4 4 5 5 4 5 5 4 5 5 4 4 4 5 5 5 4 5 4 4 5 5 4 4 4 4 4 5 5 5 5 4 5 5 4 4 5 4 4 5 5 4 4 5 5 5 5 4 4 4 4 4 4 4 5 4 4 4 5
5 4 5 5 5 4 5 5 4 4 4 4 4 5 4 5 5 5 4 4 4 5 4 4 5 5 5 4 4 5 4 5 4 4 4 5 5 4 4 4 5 4 5 4 5 4 5 5 5 5 4 4 4 4 4 5 4 4 5 5 4 4 4 4 5 5 4 5 5 5 5 5 5 4 5 5 4 5 5 4 5 5 5 5 4 4 5 5 5 4 5 5 4 5 5 4 5 5 5 4
4 4 4 5 5 4 4 5 4 5 5 4 4 4 4 5 4 5 4 5 5 5 4 5 5 4 4 5 5 4 4 5 4 4 5 4 4 4 4 4 4 5 5 5 5 5 5 5 4 4 5 4 4 4 5 5 5 5 4 4 5 4 5 4 4 4 5 5 5 5 4 5 5 4 5 4 4 4 4 4 5 4 4 4 4 5 5 4 5 4 4 4 4 5 4 5 4 5 5 5
5 5 4 4 5 4 5 4 5 4 5 5 4 5 4 4 4 4 5 4 4 5 5 5 5 5 4 4 5 4 5 4 4 4 5 4 5 5 4 4 4 4 4 5 4 4 5 5 5 5 5 4 4 5 5 5 4 4 5 5 5 5 4 5 4 5 4 4 4 4 5 4 4 4 4 5 4 5 5 5 5 5 5 5 4 5 5 5 4 5 5 5 5 5 4 5 5 5 5 4
4 4 5 4 4 5 4 5 4 5 5 5 5 5 4 4 5 5 4 4 5 4 4 5 5 4 5 4 5 4 5 4 4 4 5 5 5 4 5 5 5 5 5 4 4 5 4 5 4 5 5 5 4 4 4 4 5 4 5 5 4 4 5 4 4 5 4 4 5 4 4 5 4 4 5 4 5 5 4 4 4 5 4 4 5 4 4 4 4 5 4 5 5 4 5 5 4 5 4 5
5 4 4 5 5 4 4 4 5 5 4 5 4 5 5 4 5 5 5 5 5 4 4 5 5 4 5 5 4 4 5 5 5 4 5 4 5 4 5 5 4 5 5 5 5 4 4 4 4 4 4 5 4 4 4 5 5 5 5 4 4 4 4 4 5 5 5 4 4 5 4 4 4 5 5 4 4 5 4 5 4 5 4 5 4 4 4 5 5 4 4 5 5 5 5 5 5 5 5 4
4 5 5 5 4 5 4 5 4 4 5 5 4 5 4 5 4 4 5 4 5 4 4 5 5 4 5 4 4 5 5 5 4 4 5 5 4 5 5 4 5 4 5 5 5 5 4 4 5 5 5 5 4 5 4 4 5 5 4 4 5 5 4 5 4 5 4 5 5 4 4 4 4 4 4 4 4 5 5 5 4 5 5 5 4 4 4 4 4 4 4 4 5 5 4 5 4 5 4 5
5 4 4 4 5 4 4 5 5 4 5 5 4 5 4 5 5 4 4 4 5 5 5 5 4 4 4 4 5 5 4 5 4 5 5 4 5 5 5 4 4 4 4 4 5 4 5 4 4 5 5 4 4 5 4 5 4 4 5 5 5 4 4 5 5 5 5 4 4 4 4 5 4 5 4 5 4 4 4 4 5 5 5 5 5 4 4 5 5 4 4 5 4 5 5 4 4 4 5 5
4 4 5 5 5 4 4 5 4 5 4 5 4 4 4 4 5 5 5 5 4 4 4 4 4 4 5 5 4 4 4 5 5 4 5 5 5 5 4 4 4 5 5 4 5 5 4 4 4 5 4 4 4 4 4 5 4 5 5 4 5 4 5 5 4 5 4 5 5 4 4 5 4 4 5 5 5 5 4 4 4 4 4 5 5 5 4 5 5 4 4 4 5 4 5 4 4 4 5 4
5 4 4 5 5 5 4 4 4 4 5 4 4 5 4 5 4 5 5 4 4 5 4 5 5 4 4 4 5 5 4 5 5 4 5 4 4 5 4 4 4 4 4 5 4 5 5 4 4 4 5 4 4 4 4 4 5 4 4 5 4 5 4 5 4 5 5 4 4 5 4 4 4 5 5 5 4 4 5 5 5 4 5 5 5 4 4 4 5 5 4 5 4 5 5 4 4 4 5 4
4 5 4 5 5 5 5 4 5 4 4 5 4 4 4 4 4 5 4 4 5 5 5 5 4 4 5 4 4 4 5 5 4 4 5 5 4 5 5 5 4 5 4 5 5 4 4 5 5 5 4 5 5 5 5 4 4 4 5 5 5 4 4 4 4 4 4 4 5 4 4 5 4 5 4 4 5 4 5 5 4 4 4 4 5 4 5 4 5 5 4 5 4 4 5 4 5 4 4 4
5 4 5 4 4 4 4 4 5 4 4 5 5 5 4 5 5 5 4 5 4 5 4 5 4 4 4 5 5 5 4 4 5 4 4 5 4 5 5 4 5 4 5 5 4 4 4 5 5 4 5 4 4 5 4 5 5 4 5 5 5 4 4 5 4 4 4 4 5 4 5 4 5 4 5 4 4 5 4 4 5 5 5 5 5 4 4 5 4 4 4 4 5 5 5 4 5 4 4 5
5 4 5 4 5 4 5 4 5 4 5 4 5 5 5 5 5 5 4 4 5 5 4 5 4 4 5 5 4 4 5 5 5 4 4 4 5 4 5 5 4 4 5 5 5 5 4 4 5 4 4 5 4 4 5 5 4 5 4 5 5 4 4 4 4 4 5 5 5 5 5 5 4 4 5 4 4 4 5 4 5 5 5 4 4 5 4 4 4 5 4 4 5 5 5 5 5 5 4 4
4 4 5 5 4 5 5 4 5 5 5 4 5 4 4 5 5 4 4 5 5 5 4 4 4 5 4 5 4 4 5 5 4 4 4 4 4 5 5 4 4 4 5 5 4 5 4 4 5 4 5 5 4 5 5 4 4 4 5 4 4 4 4 5 5 4 5 5 4 5 5 4 5 4 4 4 5 5 5 4 5 4 5 4 5 4 4 4 5 4 4 4 5 4 4 4 4 4 4 5
4 5 5 5 4 4 5 4 4 4 4 5 5 5 4 4 4 4 4 4 5 4 5 4 5 5 5 4 5 4 4 5 4 4 5 5 5 5 5 5 5 5 4 5 4 4 4 4 5 5 5 4 5 4 5 5 5 5 5 4 5 5 5 4 4 4 5 4 5 5 4 4 4 4 5 4 4 5 4 4 5 4 4 5 4 4 5 4 4 5 5 4 4 5 4 5 5 4 5 5
5 4 4 4 4 5 4 5 5 4 4 4 5 5 4 4 5 5 4 5 4 5 4 5 5 4 4 4 5 4 4 5 5 5 4 4 4 4 5 4 5 5 5 4 5 5 5 5 4 4 5 5 4 5 5 5 4 4 5 5 5 4 4 4 5 4 5 4 4 5 5 4 5 5 4 4 5 5 4 5 4 4 4 5 4 5 4 4 4 4 4 4 4 4 5 4 5 4 5 5
5 4 5 4 5 4 5 5 4 5 5 5 5 5 4 5 5 4 4 5 5 5 5 4 4 4 5 5 5 5 5 4 4 4 4 4 4 5 5 5 4 4 5 4 4 5 5 4 4 5 4 5 4 5 4 4 4 5 5 4 4 5 5 5 4 5 5 4 4 5 5 4 5 5 5 5 5 4 5 5 5 5 4 4 5 4 4 5 5 5 4 5 4 5 5 5 4 4 4 5
5 4 4 5 4 4 4 4 5 5 4 5 4 4 4 4 4 4 4 5 4 4 5 4 4 5 4 4 5 4 4 5 4 4 4 5 4 4 4 4 4 4 4 5 4 5 4 4 5 4 4 5 5 4 5 5 4 4 4 4 5 4 4 4 5 4 5 5 4 5 5 4 4 5 5 4 5 5 5 4 4 4 5 4 5 4 4 4 5 5 4 4 4 5 5 4 4 4 4 4
4 4 4 4 5 4 4 4 5 4 5 4 4 4 5 4 4 4 4 4 4 4 4 4 4 5 4 4 4 4 4 5 4 5 4 4 5 5 5 4 4 5 4 5 5 4 4 4 5 4 5 5 5 5 4 5 5 5 4 4 4 4 4 5 5 5 4 4 5 4 5 4 5 4 5 5 4 4 5 4 5 4 4 4 4 5 5 4 5 4 5 4 4 4 4 4 5 5 4 5
5 5 5 5 4 4 5 4 5 4 4 4 5 4 4 4 4 4 4 4 5 5 4 4 4 5 5 4 4 5 4 5 4 4 4 4 4 4 4 5 5 5 4 4 5 5 5 5 4 5 5 4 4 5 4 5 4 5 5 5 4 4 4 4 5 5 4 4 5 5 4 4 5 4 5 5 4 5 5 4 5 5 4 5 5 4 5 5 5 5 4 4 4 5 5 5 4 4 5 4
4 5 5 5 4 4 5 5 4 5 4 4 5 4 5 4 4 4 5 5 5 5 5 5 5 5 4 4 5 5 4 5 5 5 5 5 5 4 5 5 4 4 5 4 5 4 4 5 4 5 5 5 4 5 5 5 4 5 4 5 4 4 5 5 5 5 4 5 5 4 5 4 4 4 5 5 5 5 5 5 5 5 5 5 5 4 5 5 4 5 4 4 4 5 4 5 4 5 4 5
4 4 4 5 5 5 5 5 5 4 4 4 4 4 5 5 5 5 5 4 5 5 4 5 5 4 5 4 4 5 4 5 5 4 4 4 5 4 5 5 5 4 5 5 5 5 5 5 4 5 4 5 4 4 5 4 5 5 4 5 4 4 4 4 5 4 4 5 5 5 4 4 4 4 5 5 4 5 4 4 4 5 4 5 5 5 5 4 4 5 4 4 4 5 4 4 5 5 5 4
4 4 4 5 5 4 4 5 4 5 4 4 5 5 5 5 4 5 5 5 4 4 4 4 4 4 4 4 5 5 4 5 4 4 4 5 4 4 5 5 5 4 4 4 4 5 5 5 4 4 5 4 4 4 4 5 5 4 5 5 5 4 4 4 4 5 4 4 4 4 5 4 4 5 4 5 4 4 5 4 5 5 4 5 4 5 5 4 5 5 5 4 5 5 5 4 4 5 5 5
4 5 4 4 4 5 5 4 5 5 5 4 5 4 5 4 5 5 4 4 5 4 4 4 4 4 4 4 4 5 5 4 4 4 4 5 4 5 5 4 4 4 5 4 4 5 4 4 5 5 5 5 5 5 5 5 5 4 4 4 5 4 4 4 4 4 5 4 5 4 5 4 4 4 5 4 4 4 4 5 4 4 5 5 5 4 5 4 5 5 4 4 5 5 5 5 5 5 5 5
4 4 4 5 5 5 4 5 5 4 5 5 5 4 4 4 5 4 4 5 4 4 4 4 5 4 5 5 5 5 4 4 4 4 5 4 4 4 5 4 5 4 4 4 4 5 5 4 4 5 4 5 5 5 5 4 4 5 5 4 5 4 4 5 4 5 4 4 4 4 5 5 5 5 5 4 4 4 4 4 5 5 5 4 5 5 4 4 4 5 5 5 4 4 4 5 5 5 5 4
5 4 4 4 5 4 5 4 5 5 5 5 4 5 5 4 5 4 4 4 4 5 5 5 4 5 5 5 5 5 5 4 4 5 5 5 4 5 5 5 5 5 4 5 4 5 5 5 4 4 5 4 5 5 4 5 5 4 5 5 5 4 4 5 5 4 5 5 4 5 4 4 5 4 4 5 5 4 5 5 5 4 5 4 5 4 5 5 4 5 4 5 5 4 5 5 4 4 4 4
4 5 5 5 5 5 5 5 5 4 5 5 4 5 4 4 4 5 4 4 5 4 4 4 5 4 5 5 4 5 4 5 5 5 5 4 4 4 4 5 4 4 4 5 4 4 4 4 4 4 4 4 4 5 4 5 4 4 4 4 5 4 4 5 5 5 4 4 5 5 5 4 5 5 5 4 4 4 4 4 5 4 5 5 4 5 5 5 4 5 4 4 5 5 5 5 5 4 4 4
4 5 5 4 5 5 5 4 5 4 5 4 4 5 5 4 5 4 4 4 5 5 4 5 4 4 5 5 4 5 4 5 4 4 5 5 4 5 4 4 4 4 5 5 5 5 4 5 4 5 5 4 5 4 4 4 4 5 4 4 4 5 5 4 4 5 4 4 4 4 5 5 4 5 5 5 4 4 4 4 4 4 5 4 4 4 5 5 5 5 5 4 4 4 5 5 4 5 4 4
5 4 5 4 4 4 5 5 4 4 5 4 4 5 5 4 4 5 4 5 5 4 4 5 5 4 4 4 5 5 4 4 5 5 4 5 4 4 5 4 4 5 5 4 5 5 5 5 5 4 5 5 4 5 5 4 5 4 5 5 4 4 5 5 4 5 5 4 4 4 4 4 5 5 4 5 5 4 5 4 5 5 4 5 5 4 5 5 5 5 4 4 5 5 5 5 4 4 4 5
4 5 5 5 5 4 4 4 4 4 4 5 4 5 4 5 5 4 4 5 4 5 5 4 5 5 5 4 5 4 4 5 5 5 5 4 4 5 5 5 4 4 4 5 4 5 5 4 5 5 4 5 5 5 5 4 5 5 4 4 4 4 4 5 4 5 5 5 4 5 5 5 4 5 4 4 4 5 5 4 4 5 5 5 4 5 5 4 5 5 5 4 4 5 4 4 5 4 4 4
4 5 5 5 5 5 4 5 5 4 5 5 4 5 5 5 5 4 5 4 5 4 4 5 5 4 5 5 4 4 4 4 4 5 4 5 5 4 4 5 4 5 5 5 4 5 5 5 5 5 5 4 5 5 5 5 5 4 4 5 4 5 4 5 5 5 5 4 4 5 4 4 5 4 5 5 5 5 5 5 5 5 5 5 4 4 5 4 4 4 4 5 5 5 4 4 4 5 4 5
4 5 4 4 4 4 5 4 4 4 4 5 4 5 5 4 4 4 5 4 5 5 4 4 4 4 5 5 5 4 5 5 4 5 5 5 4 4 4 4 5 5 5 5 5 4 4 5 4 5 4 5 5 5 5 4 4 5 4 5 4 4 5 4 4 5 5 5 5 4 4 5 4 5 5 5 4 4 4 4 4 5 5 5 5 4 5 5 5 5 5 4 5 5 4 5 4 4 5 4
5 5 5 4 5 5 4 5 4 5 4 4 4 4 4 4 4 5 5 4 5 4 4 4 5 4 5 5 5 4 5 5 4 4 5 5 5 5 5 4 5 4 4 4 4 4 5 4 4 5 5 5 5 5 4 4 4 5 4 4 5 4 5 4 5 4 5 5 4 4 4 4 5 4 5 5 5 4 5 4 5 4 4 5 5 5 5 4 5 4 4 5 5 4 4 5 5 5 4 4
4 5 4 5 5 5 4 5 5 5 5 5 5 5 5 4 5 5 5 4 5 4 4 4 4 5 4 5 5 4 4 4 4 5 5 5 5 5 5 4 5 5 4 4 4 4 5 4 5 4 4 5 4 4 5 4 5 5 4 4 5 5 5 4 5 4 5 4 4 4 5 5 5 4 5 5 5 5 4 4 5 5 5 4 4 4 5 4 4 5 5 4 5 4 5 4 5 5 4 4
5 4 5 5 5 5 5 4 4 4 5 5 4 4 4 4 4 5 4 4 4 5 4 4 5 4 5 5 5 5 5 5 4 5 5 4 5 4 4 4 4 4 4 5 4 4 4 4 4 4 4 4 4 4 5 4 4 5 5 4 4 4 5 4 5 5 5 5 5 5 4 4 4 4 4 5 4 4 5 5 4 4 5 4 4 4 5 5 4 5 5 4 4 5 5 4 4 4 4 5
4 5 4 4 4 5 5 5 4 4 4 4 4 5 4 4 5 4 5 5 5 4 5 4 4 4 4 4 5 4 5 4 5 5 4 5 5 5 4 4 5 5 5 5 4 4 4 4 5 4 5 5 5 4 5 4 4 5 4 4 5 5 5 4 4 5 5 4 5 5 4 4 4 5 4 5 5 5 4 5 4 4 5 4 5 4 5 4 4 4 4 4 4 5 4 5 5 5 4 5
4 5 5 4 5 5 4 4 5 4 5 4 4 5 4 4 5 4 5 4 4 5 4 4 5 4 5 5 5 5 4 4 4 5 4 5 5 5 5 4 4 4 5 4 4 5 4 5 5 4 5 4 4 5 5 4 5 4 4 5 5 4 4 5 4 5 4 4 4 4 5 4 5 5 5 5 4 4 4 5 4 4 5 4 4 4 4 4 4 4 4 4 4 5 5 5 4 4 4 4
5 5 4 4 5 4 5 5 5 4 5 4 5 4 4 4 5 4 4 4 5 4 4 4 5 4 4 4 5 4 5 4 4 5 5 5 5 5 4 5 5 5 5 5 5 5 5 5 4 5 4 4 4 5 4 4 5 5 4 4 5 5 5 5 5 5 4 5 5 4 4 4 5 4 5 4 5 4 4 4 5 5 4 5 5 4 4 5 4 4 4 4 4 4 4 5 5 4 4 5
4 4 4 4 4 4 4 5 4 4 4 5 5 4 4 4 4 5 5 5 4 5 5 5 5 4 4 4 5 4 4 5 4 4 5 5 4 5 4 4 5 4 5 5 4 5 5 4 4 4 5 5 5 4 5 4 4 4 5 5 4 5 5 4 4 5 5 4 4 5 4 5 5 4 4 4 5 4 4 4 4 4 4 4 4 4 5 5 5 5 4 5 5 5 5 4 5 5 5 4
4 5 5 4 5 4 4 4 4 4 4 5 4 5 4 5 4 5 4 4 5 5 5 5 5 5 4 5 5 5 5 4 4 4 5 5 5 4 5 4 4 4 4 5 4 5 4 5 5 4 5 5 5 4 4 5 5 5 5 4 5 5 4 4 4 5 5 5 5 4 4 5 5 5 5 5 5 4 5 4 5 4 4 5 5 4 5 5 5 5 5 5 4 4 5 4 4 4 5 5
5 5 5 4 5 5 4 4 4 5 5 5 5 4 5 4 4 5 5 4 5 4 4 4 4 4 4 4 5 5 5 4 4 5 4 4 4 5 4 4 4 4 4 5 5 4 5 5 4 0 5 5 4 1 5 5 5 5 5 4 5 5 4 5 5 4 4 4 5 4 4 4 5 5 4 4 4 4 5 5 4 4 5 4 5 5 4 4 4 4 5 4 4 5 5 5 5 4 4 5
4 4 4 4 5 5 4 5 5 4 4 4 4 5 4 5 4 5 5 4 4 4 5 5 5 4 5 4 5 5 4 4 5 4 5 4 5 5 4 4 5 5 5 5 4 4 5 1 1 4 4 1 4 4 4 4 4 5 4 4 4 4 4 4 4 4 5 4 4 5 4 4 5 5 5 4 5 5 4 4 4 4 5 5 4 4 5 5 5 4 5 5 4 4 5 4 4 5 4 4
4 4 5 5 5 4 4 5 5 4 4 5 4 4 5 5 5 5 4 5 4 5 4 5 5 4 4 4 4 5 4 4 5 4 4 4 4 5 5 5 4 5 4 5 5 4 5 5 4 5 4 5 4 4 4 5 5 4 4 4 5 5 5 4 4 5 5 5 4 5 4 4 4 4 4 5 4 4 5 4 5 4 5 4 4 4 4 4 4 5 4 4 5 4 5 5 5 4 5 5
4 4 4 5 5 4 4 5 5 5 4 4 4 4 4 5 4 5 5 5 5 4 4 4 5 4 5 4 4 5 4 4 4 4 5 4 4 5 4 4 4 5 5 4 5 5 4 5 4 4 0 5 4 1 4 4 5 4 5 4 4 4 5 4 4 4 5 5 4 5 4 4 4 5 4 5 4 4 4 5 5 4 4 4 5 4 5 5 5 5 5 5 4 4 5 4 5 5 5 5
5 4 5 4 5 5 4 5 4 5 5 5 4 4 5 4 5 5 4 4 4 4 5 4 4 5 5 4 5 5 4 4 4 4 5 5 4 4 4 4 4 5 4 5 5 5 4 5 1 4 4 4 4 4 5 5 4 5 4 5 4 5 5 5 4 4 5 5 5 5 4 5 5 5 5 4 5 4 4 5 5 4 5 4 5 5 4 5 5 4 5 4 4 5 5 5 5 5 4 4
5 4 4 5 5 4 4 4 5 5 5 5 4 4 5 4 5 5 4 5 4 5 4 4 5 5 5 4 5 4 4 4 4 4 5 4 5 4 5 5 4 4 4 5 5 5 5 5 5 5 4 0 5 5 5 4 5 4 5 5 5 4 5 5 5 4 5 4 5 5 5 5 5 4 5 4 5 5 4 5 4 4 4 4 5 4 5 4 4 4 4 5 4 5 4 5 4 5 5 4
5 5 5 5 4 5 4 5 4 5 5 5 5 5 5 4 4 5 4 5 4 5 4 4 4 4 4 5 4 5 5 5 4 4 4 4 4 4 4 5 4 5 4 5 4 5 5 4 5 4 5 4 5 5 5 5 4 5 4 4 5 4 5 4 4 5 4 4 5 4 5 4 5 5 4 4 4 4 5 5 4 4 5 4 5 4 5 5 5 5 5 5 5 5 4 4 5 4 4 5
4 4 5 5 4 5 5 5 4 5 5 4 4 5 4 4 5 4 4 5 4 4 5 4 4 4 5 4 4 5 5 4 5 5 5 4 4 4 4 4 4 5 5 5 4 4 4 4 5 5 5 4 5 4 4 5 4 5 5 4 5 5 5 5 5 5 5 4 5 5 4 4 4 5 4 4 5 5 4 5 5 5 5 4 5 5 5 5 5 5 5 4 5 4 5 5 4 4 4 4
4 5 4 4 5 5 5 5 4 5 5 4 4 4 4 5 4 4 5 4 5 4 4 5 4 5 4 5 5 4 4 4 5 5 4 5 5 5 4 4 4 5 5 5 5 5 4 4 5 4 4 5 5 4 4 4 4 4 4 4 5 5 4 4 5 5 4 5 4 4 5 4 4 5 5 4 5 5 4 4 5 4 4 5 5 4 5 4 4 5 5 5 5 4 5 4 5 5 5 5
5 4 5 4 5 4 5 5 4 5 5 4 5 5 5 5 5 4 5 5 5 4 5 4 5 4 5 5 5 5 4 5 5 4 5 4 4 5 4 5 4 5 5 5 4 5 4 4 5 5 4 5 4 4 4 5 5 4 5 4 5 4 5 4 5 4 5 4 5 4 4 5 4 5 4 5 4 5 5 5 5 5 4 4 4 5 5 5 4 5 4 4 5 5 4 5 4 5 4 5
5 5 4 5 5 5 5 4 5 4 5 5 5 4 5 4 5 4 5 4 5 4 5 5 4 5 4 5 4 5 4 5 4 5 4 4 4 4 4 5 5 5 5 5 5 4 5 4 5 5 4 4 5 5 4 4 5 5 5 4 4 4 5 4 5 5 5 5 5 4 5 4 5 5 5 4 4 5 4 4 5 4 4 5 5 5 5 4 5 4 5 4 5 5 5 4 5 5 5 4
4 4 5 4 4 5 5 4 5 5 4 4 5 4 5 5 4 4 5 4 5 4 5 4 5 5 5 5 5 5 5 5 5 5 5 4 4 4 5 5 5 5 5 5 5 5 5 4 4 5 4 5 5 5 4 5 4 4 4 5 5 4 4 4 5 4 4 5 5 4 4 4 5 4 4 4 4 5 4 5 4 5 4 4 4 4 5 4 4 4 4 4 5 5 4 5 5 4 5 4
5 4 5 4 4 4 5 5 5 4 4 4 4 5 5 5 4 5 4 4 5 5 4 5 5 5 5 5 4 4 5 5 5 4 5 5 4 5 4 4 4 5 5 5 5 5 4 5 5 5 4 5 4 5 4 4 4 4 4 5 4 5 5 4 4 4 5 4 4 4 5 5 4 4 4 4 4 4 4 4 4 4 5 4 4 5 4 4 4 5 5 5 4 5 4 4 5 5 4 4
4 5 5 5 5 4 5 4 4 5 4 5 5 5 4 4 4 4 4 5 5 5 4 5 5 5 5 5 5 5 5 5 4 5 4 5 5 5 5 4 5 5 5 4 5 4 4 4 4 5 4 5 5 4 5 4 4 4 5 5 4 4 4 4 4 5 4 5 4 4 4 4 4 4 4 5 5 4 5 4 5 5 4 5 5 5 4 4 4 5 4 4 5 5 4 4 5 5 5 4
4 5 5 4 5 4 5 5 4 4 5 4 5 4 4 4 4 4 5 5 4 5 5 5 5 4 4 4 5 5 5 4 5 5 4 5 4 4 4 4 4 4 4 5 5 5 4 5 4 4 4 5 5 5 5 5 5 5 5 4 4 4 4 5 4 5 4 5 4 5 5 5 5 5 5 5 5 5 5 5 4 4 5 5 4 5 4 4 4 5 4 5 5 4 4 5 4 5 4 5
4 5 4 4 5 4 5 4 5 4 5 4 5 4 5 4 5 5 4 5 4 4 4 5 4 4 4 5 4 5 5 4 4 4 4 5 5 5 4 5 5 4 5 4 5 4 4 5 5 4 4 5 5 5 4 4 4 5 4 5 4 5 4 5 5 5 5 4 4 5 4 5 5 5 5 4 5 5 5 5 5 4 5 4 5 5 4 4 4 5 4 4 5 4 5 5 5 4 5 5
5 5 5 5 5 5 5 4 4 5 4 5 4 5 5 5 5 5 5 5 5 4 5 4 5 5 4 5 4 4 5 4 5 5 5 4 5 4 5 4 4 4 4 5 4 4 5 4 4 4 4 4 4 4 4 4 4 4 5 5 4 4 5 5 4 5 5 5 5 5 5 5 4 5 4 4 4 5 4 4 5 4 4 4 4 4 4 5 4 5 4 4 4 4 4 5 5 4 4 4
4 5 5 4 5 4 5 4 5 4 5 5 4 5 4 5 4 4 4 5 4 5 5 4 5 4 4 5 4 5 5 5 5 5 4 4 4 5 5 5 5 5 5 4 4 5 4 5 5 5 5 4 5 5 4 4 5 5 5 5 4 4 5 5 4 4 4 5 4 5 5 4 5 5 5 4 4 4 4 5 5 5 4 4 4 4 4 4 4 4 4 4 5 4 4 4 4 5 5 5
4 5 4 5 4 5 4 4 4 5 5 4 4 4 4 5 5 5 5 5 5 5 4 5 5 5 4 5 4 5 5 4 5 5 5 5 4 5 4 4 4 4 5 4 4 5 4 5 4 4 5 4 5 4 5 5 5 5 5 5 5 5 4 4 5 4 5 4 4 5 4 4 4 5 5 4 4 5 5 4 5 5 4 4 4 4 4 5 4 5 4 4 5 4 5 5 4 5 4 4
4 5 4 5 4 4 4 4 4 5 4 4 4 4 4 5 4 4 5 4 4 5 4 4 5 4 4 4 4 5 4 5 5 4 5 4 4 4 5 5 4 5 5 5 4 4 5 5 4 4 4 5 5 4 4 4 5 4 4 5 4 5 4 5 5 4 5 5 4 4 5 5 5 5 4 4 5 5 5 4 5 4 5 5 5 4 5 5 5 5 5 5 4 5 5 5 5 5 4 4
4 4 5 4 4 5 4 5 5 4 5 4 4 4 5 4 5 5 5 5 5 5 5 4 4 5 5 5 4 5 4 5 5 4 5 4 5 5 5 4 5 5 4 5 5 4 4 5 5 4 4 4 4 5 4 4 5 5 4 5 5 5 5 5 5 4 4 5 5 5 5 5 4 5 4 5 4 5 5 5 4 4 4 4 5 4 5 4 4 5 5 5 4 4 5 4 4 5 4 4
4 4 5 4 5 4 5 4 5 5 5 4 4 5 5 5 4 5 4 5 4 5 4 4 4 5 5 5 4 5 5 4 4 5 5 5 5 4 4 4 4 5 5 5 5 4 4 5 4 4 5 4 4 5 5 4 4 4 5 5 4 5 4 5 4 4 4 4 5 4 4 4 4 5 4 4 5 4 4 4 4 5 4 4 4 5 4 4 5 4 4 5 5 5 5 5 5 4 4 4
5 5 4 4 4 5 5 5 4 5 4 5 4 4 4 5 5 5 4 5 5 5 5 5 5 4 4 5 4 4 5 4 4 5 4 4 4 4 4 5 4 5 4 4 4 4 4 5 4 5 4 5 5 5 5 4 4 4 4 5 5 5 5 4 4 5 5 5 4 5 5 5 5 5 4 4 4 4 5 4 5 5 4 4 5 4 4 5 5 5 4 5 5 4 4 4 4 4 4 4
5 4 5 4 5 5 4 5 4 5 5 4 4 4 4 5 5 5 5 4 5 4 4 5 4 4 4 4 5 5 5 4 4 4 4 4 5 5 5 4 4 5 4 5 4 4 5 4 4 5 4 4 4 5 5 4 5 4 5 5 5 4 4 5 5 4 5 5 5 5 4 5 5 4 4 4 4 4 5 4 4 4 4 4 4 5 5 5 5 4 5 5 4 5 4 4 5 5 5 4
5 5 5 4 5 5 4 5 4 4 4 4 4 5 4 5 5 4 4 4 4 4 5 5 4 5 5 5 4 4 5 4 4 5 4 4 4 4 5 4 5 4 5 4 4 4 5 5 5 5 4 4 4 5 4 5 5 4 5 4 4 5 5 4 4 4 4 4 5 5 5 5 5 5 5 4 5 4 4 5 4 4 5 4 5 5 4 4 5 5 5 5 5 4 5 5 5 5 5 4
5 4 4 5 4 5 5 5 4 4 5 4 4 4 5 4 4 4 5 4 5 5 4 4 5 5 4 5 5 4 4 5 4 4 4 5 5 4 4 4 5 4 4 5 4 4 5 4 4 5 5 4 4 5 5 5 4 4 4 4 4 5 5 4 4 5 4 4 5 5 5 4 4 5 5 4 4 4 4 5 4 5 4 5 5 5 4 4 5 4 5 5 5 5 4 4 4 5 5 4
5 4 4 4 4 4 5 4 4 4 4 5 4 5 4 4 4 4 5 4 4 5 5 4 4 5 4 5 5 5 5 4 4 5 4 5 4 4 5 5 4 4 5 4 5 5 4 5 5 5 4 4 5 5 4 5 4 4 5 4 4 5 5 5 5 5 4 5 5 4 4 5 4 5 4 4 4 5 5 5 5 5 4 4 5 5 4 4 5 4 5 4 5 4 4 4 5 4 5 5
5 5 5 4 4 4 5 4 5 4 5 5 4 4 4 4 4 4 5 4 4 5 4 4 5 5 5 4 5 5 5 5 4 4 5 4 5 5 5 4 4 5 4 4 4 4 4 4 4 5 5 5 5 4 4 4 4 4 5 4 5 5 4 5 4 4 5 5 5 5 5 5 5 4 4 4 4 5 5 5 5 4 4 5 5 4 4 4 5 5 4 4 4 4 5 4 4 5 4 5
4 4 4 5 4 4 4 4 5 4 5 5 5 5 4 4 4 5 4 5 4 4 4 4 5 4 5 4 4 5 4 4 4 4 5 5 5 5 5 5 5 4 5 5 4 5 4 4 4 5 5 5 4 5 4 5 4 5 4 4 4 5 5 5 4 4 4 5 5 5 4 4 4 4 5 5 4 5 5 5 5 5 4 4 5 5 5 4 5 5 5 5 4 4 4 5 4 5 4 5
5 4 5 5 5 5 4 4 5 5 4 5 4 5 5 5 4 4 4 4 5 4 4 4 5 5 4 4 5 4 4 5 5 4 4 5 4 4 4 4 5 4 5 4 5 5 5 5 4 5 5 5 4 4 4 5 4 5 4 5 5 5 4 5 4 4 4 4 4 5 4 5 4 4 4 4 5 5 4 5 4 5 5 5 4 4 4 4 5 4 4 4 5 5 5 5 5 5 5 5
5 5 4 4 4 5 4 5 5 5 4 5 4 4 4 5 4 5 5 4 4 5 5 5 5 5 5 5 5 5 5 5 5 4 4 5 5 5 4 5 5 4 5 5 4 4 5 4 5 5 4 5 4 4 4 5 4 5 5 5 4 4 4 5 4 4 4 4 4 4 5 4 5 4 4 5 5 4 5 5 5 4 4 4 4 5 4 5 4 5 4 4 5 4 5 4 4 4 4 4
4 4 4 5 5 4 5 5 4 4 5 5 4 5 4 4 4 5 5 5 4 4 4 5 4 5 4 5 5 4 5 5 4 5 5 4 5 5 5 5 5 5 5 5 5 4 5 4 4 4 4 5 4 4 5 4 4 4 4 4 5 5 5 5 5 4 4 4 5 4 4 5 5 4 5 5 4 5 5 4 5 4 5 5 4 4 5 5 4 5 4 4 4 5 5 4 4 4 4 5
4 4 4 4 4 5 4 4 4 4 4 4 5 4 5 4 5 5 4 5 5 5 4 5 4 5 5 4 5 5 4 5 5 4 5 5 5 5 4 4 4 4 5 5 5 5 5 5 4 4 4 4 4 4 4 5 4 5 4 5 4 4 5 5 4 5 4 5 5 4 5 4 5 4 4 4 5 4 5 5 5 4 4 5 5 5 5 5 4 5 5 5 4 5 4 5 5 5 5 5
5 5 4 5 5 4 5 4 4 4 4 5 4 4 5 4 5 4 5 4 4 4 4 4 5 5 5 5 4 4 5 4 5 5 5 4 5 4 4 5 4 4 4 4 5 4 5 5 5 5 4 5 4 5 5 5 4 4 4 4 5 4 5 4 5 4 5 5 4 5 4 4 5 4 4 4 4 4 4 5 4 5 4 5 4 4 4 5 4 5 5 5 4 5 5 5 4 4 4 4
5 5 5 5 4 5 4 4 4 5 5 4 4 4 5 4 4 5 5 5 5 5 4 4 5 4 5 5 4 4 5 5 5 4 4 5 5 4 4 5 5 4 4 4 5 4 5 4 5 5 4 5 4 5 4 5 5 5 5 4 5 4 5 5 4 4 5 5 4 5 4 4 4 5 4 5 5 5 5 4 4 5 5 5 5 4 5 5 4 5 5 4 5 4 4 5 5 4 5 5
4 4 4 4 4 5 5 4 4 4 4 4 4 4 5 4 4 5 4 5 5 4 5 5 5 4 5 4 5 4 5 5 5 4 4 5 5 5 4 4 5 4 4 4 5 5 4 5 5 4 5 5 5 5 4 4 4 4 4 4 5 4 4 4 5 5 4 5 4 5 5 5 4 4 5 4 4 5 5 5 5 5 5 4 5 4 5 4 5 4 5 5 5 4 5 4 5 5 4 5
5 4 4 4 5 5 4 5 4 4 5 4 4 4 5 5 4 5 4 5 5 5 5 4 5 4 4 4 5 4 5 5 4 5 4 4 5 4 4 5 4 5 5 4 5 4 4 4 5 5 4 5 4 4 4 5 4 5 5 5 4 5 4 4 4 5 4 5 4 4 5 5 4 4 4 4 5 4 5 4 5 5 4 5 5 4 5 5 5 5 5 4 4 4 4 4 4 5 4 4
5 4 5 5 4 4 4 4 5 4 5 4 4 5 5 5 5 5 5 4 5 5 5 5 5 4 5 5 4 4 4 4 5 4 4 5 4 5 4 4 4 5 4 5 4 4 5 5 4 4 4 4 4 5 4 5 5 5 5 5 4 5 5 4 4 5 4 5 5 4 4 5 5 4 5 5 5 5 5 4 4 4 5 5 4 5 4 4 4 5 5 4 4 5 5 5 5 5 4 5
5 5 5 4 4 5 4 4 4 5 5 5 5 5 4 5 5 5 4 5 4 4 4 4 4 4 4 5 4 5 5 4 4 4 5 4 5 5 4 5 5 4 4 5 5 5 4 5 4 4 5 4 5 5 4 5 4 4 4 5 4 4 4 4 4 5 4 5 4 4 4 4 5 4 4 5 4 4 4 5 4 5 4 4 5 4 4 4 5 5 4 4 4 5 4 5 5 5 4 4
5 5 4 5 4 5 4 4 4 5 4 4 5 5 5 5 4 5 4 5 4 5 5 5 4 4 4 4 5 4 5 5 4 4 5 5 4 5 4 4 4 4 5 5 4 5 4 4 5 5 4 4 4 5 4 5 5 5 5 4 4 4 5 5 4 5 5 5 4 4 4 4 5 5 5 4 5 5 4 5 4 5 4 4 4 5 4 5 5 4 4 5 4 4 5 4 4 4 4 4
5 4 5 5 5 5 5 5 4 5 5 4 4 5 4 5 4 4 4 5 4 5 4 4 4 5 4 5 4 5 4 4 4 4 4 4 5 4 5 4 4 5 4 5 4 4 4 4 5 5 5 4 4 4 4 4 5 4 5 4 4 4 5 5 4 4 4 5 4 5 4 5 5 4 5 5 4 5 5 4 5 4 4 5 4 5 4 5 5 4 4 4 4 5 4 4 5 4 5 5
5 4 4 4 4 4 5 5 4 5 4 4 4 5 5 5 5 4 5 4 4 5 5 4 4 5 4 4 5 4 5 5 5 5 4 5 5 5 4 5 5 4 4 4 5 5 5 4 5 4 4 5 4 4 5 5 5 5 4 4 4 4 5 5 4 5 4 5 5 4 4 5 5 4 5 5 4 5 4 4 4 5 5 5 4 4 4 4 4 4 5 5 5 5 4 5 4 4 5 5
5 5 4 5 4 4 4 4 5 5 4 5 5 4 4 5 4 4 4 5 5 4 5 4 4 5 4 5 5 4 4 5 4 4 4 4 4 4 4 4 5 5 5 5 4 4 4 4 5 5 4 4 5 4 5 4 5 4 5 5 5 5 4 4 5 5 4 5 5 5 5 5 4 5 4 5 5 5 5 5 5 5 4 5 4 4 4 5 4 5 4 4 4 5 4 4 4 4 4 5
4 4 4 4 4 4 5 4 4 4 4 4 4 4 4 4 4 5 5 5 4 4 5 5 5 4 4 5 4 4 4 5 4 4 4 4 4 5 5 4 4 5 5 5 4 4 4 5 5 4 4 4 5 5 4 4 4 5 5 4 4 4 4 4 5 4 5 5 4 4 4 5 4 4 4 4 4 5 5 4 4 5 4 4 4 4 4 4 4 5 4 4 5 4 4 5 5 4 4 5
4 5 5 4 4 5 5 4 5 5 5 5 5 4 4 4 4 4 5 4 5 4 4 5 5 4 5 4 5 5 4 4 4 4 4 4 5 4 4 5 4 4 4 5 5 4 4 4 5 4 5 4 4 4 4 4 4 5 5 5 4 4 5 5 5 5 5 4 4 4 4 4 4 4 4 4 4 5 4 5 5 5 5 5 5 5 4 5 5 5 5 5 5 4 5 4 5 4 4 5
5 5 4 4 5 5 4 4 5 4 4 5 4 4 4 4 5 5 4 4 4 4 5 4 4 4 4 4 5 4 5 5 4 4 5 4 5 5 5 5 5 4 5 5 4 4 5 5 4 4 5 5 4 4 5 4 4 4 5 5 5 5 4 5 5 4 5 4 5 5 4 4 5 5 4 4 4 5 5 5 5 4 4 4 4 4 5 5 5 5 4 5 5 4 4 4 5 4 5 4
5 4 4 5 4 5 5 4 5 5 4 4 5 5 4 5 5 4 4 4 5 4 4 5 5 4 5 5 4 4 4 5 5 4 4 5 4 5 5 4 4 5 5 5 4 5 5 5 4 5 5 5 4 5 5 5 5 5 4 4 5 5 4 4 4 4 5 5 5 4 4 4 5 5 4 4 4 5 5 4 5 5 5 5 4 5 4 4 4 5 5 4 4 4 4 5 5 5 4 4
4 4 5 4 4 4 4 5 4 5 4 5 5 5 5 4 4 5 5 5 4 4 4 5 5 4 4 4 4 5 4 4 5 5 4 5 4 5 5 4 5 4 4 4 5 4 5 4 4 4 5 5 5 5 5 4 4 4 5 5 5 5 4 5 5 5 4 4 5 5 5 4 4 5 4 5 5 4 4 5 4 5 4 5 4 4 4 5 5 5 4 5 4 4 5 4 4 4 5 4
4 4 5 5 5 4 5 4 4 5 4 5 4 5 4 4 4 5 5 5 4 4 5 5 4 4 4 5 5 4 4 4 5 5 4 5 5 5 4 5 4 5 4 4 4 4 4 5 4 4 5 4 4 5 4 4 4 4 4 4 4 4 4 4 5 4 5 4 5 5 5 4 5 4 5 4 5 4 4 4 5 4 5 4 4 5 5 4 5 5 5 4 5 5 4 4 5 4 5 4
4 5 5 5 5 4 5 4 4 4 4 4 5 4 5 5 5 5 4 5 5 5 5 4 4 4 4 4 5 4 5 4 5 5 5 5 4 4 5 4 4 5 5 4 5 4 4 4 4 4 5 4 4 4 4 4 5 4 5 4 4 5 4 5 4 4 4 4 5 5 4 5 5 5 4 4 4 4 4 4 5 5 5 5 5 5 4 5 5 5 4 4 4 5 4 5 5 5 4 5
4 4 5 5 5 4 5 5 4 4 5 5 4 4 5 5 5 4 5 4 5 5 4 5 5 5 4 5 5 5 5 5 4 5 5 4 5 5 4 4 4 5 4 5 4 5 4 5 5 4 5 4 4 5 5 5 5 5 4 5 4 5 4 4 5 4 5 5 5 4 4 5 4 4 5 5 5 5 4 4 5 5 5 5 4 4 5 4 4 4 4 5 4 5 5 5 4 4 4 4